üéØ Immediate UX/UI Enhancements
Smart Form Improvements
Bulk Import: CSV/Excel upload for multiple affiliate links
URL Validation: Real-time link testing and commission verification
Auto-Complete: Product suggestions based on merchant patterns
Template System: Pre-configured templates for different niches
Drag & Drop: Visual link management with card-based interface
Enhanced Auto-Fill Intelligence
AI-Powered Extraction: Use GPT/Claude to extract better product details
Image Recognition: Auto-generate alt text and SEO descriptions
Competitor Analysis: Auto-suggest similar products and pricing
Commission Tracking: Real-time commission rate verification
üöÄ Advanced Automation Features
Intelligent Workflow Engine
typescript
Copy Code
// Enhanced workflow with conditional logic
interface WorkflowRule {
  trigger: 'new_product' | 'price_change' | 'seasonal' | 'performance';
  conditions: WorkflowCondition[];
  actions: AutomationAction[];
  priority: number;
}
Smart Scheduling & Optimization
Peak Time Analysis: Post content when audience is most active
A/B Testing: Auto-test different content variations
Performance-Based Adjustments: Auto-pause low-performing links
Seasonal Optimization: Adjust strategies based on trends
üìä Advanced Analytics Dashboard
Real-Time Performance Tracking
Revenue Attribution: Track which content drives sales
Conversion Funnels: Visualize customer journey
Heatmaps: See which products get most attention
Predictive Analytics: Forecast performance trends
AI-Powered Insights
Content Performance AI: Suggest content improvements
Market Trend Analysis: Identify emerging opportunities
Competitor Intelligence: Track competitor strategies
ROI Optimization: Auto-suggest budget allocation
ü§ñ Next-Level Automation
Multi-Channel Integration
Social Media Automation: Auto-post to Instagram, TikTok, YouTube
Email Marketing: Automated newsletter generation
SEO Optimization: Auto-generate meta tags and schema
Video Content: Auto-create product review videos
Advanced AI Content Engine
typescript
Copy Code
interface ContentStrategy {
  productType: string;
  audience: AudienceSegment;
  contentFormats: ('blog' | 'video' | 'social' | 'email')[];
  aiModel: 'gpt-4' | 'claude' | 'custom';
  brandVoice: BrandVoiceConfig;
}
üîê Enterprise-Grade Features
Advanced Security & Compliance
Link Cloaking: Protect affiliate IDs
GDPR Compliance: Auto-handle data privacy
FTC Disclosure: Auto-add required disclaimers
Brand Safety: Content moderation and filtering
Team Collaboration
Multi-User Access: Role-based permissions
Approval Workflows: Content review processes
Collaboration Tools: Comments and version control
Client Portals: White-label dashboards
üí° Innovative Enhancements
Voice & Mobile Integration
Voice Commands: "Add new Amazon product for [keyword]"
Mobile App: Manage automation on-the-go
QR Code Generation: Easy link sharing
AR Product Previews: Enhanced shopping experience
Marketplace Integration
Multi-Platform Support: Amazon, ClickBank, ShareASale, etc.
Price Monitoring: Auto-alert on price changes
Inventory Tracking: Hide out-of-stock products
Dynamic Pricing: Adjust based on competition
üé® UI/UX Redesign Concepts
Modern Interface Elements
Dark/Light Mode: Professional theme switching
Drag & Drop Builder: Visual content creation
Interactive Tutorials: Onboarding guidance
Customizable Dashboards: Personalized layouts
Advanced Visualization
3D Product Previews: Immersive product display
Interactive Charts: Clickable analytics
Real-Time Updates: Live performance feeds
Gamification: Achievement system for milestones